F 139,99,120
C 171,154,120

NO textures/simonkraft/bookshelf.xp
SO textures/simonkraft/bookshelf_01.xpm
WE textures/simonkraft/bookshelf_02.xpm
EA textures/simonkraft/bookshelf_03.xpm

1111111111111111111
1001001001001001001
1001001001001001001
1111111111111111111